111111111111111111111111111111111111111111111111111111111111111111111111111111111111111111111111111111111111111111111111111111111111111
11                        11                11                11                                                                     11
11                        11                11                11                                                                     11
11                        11                11                11                                                                     11
11                        11                11                11                                                                     11
11                        11                11       11       11           1          1111111111111111111111111111111111111111111111111
11                                 11                11       11           1                                                         11
11                                 11                11       11           1                                                         11
11                                 11                11       11           1                                                         11
11                                 11                11       11           1                                                         11
11                                 11                11       11           1                                                         11
11           111111111111111111111111111111111111111111       11           11111111111111111111111111111111111111111111111           11
11                                                   11       11                1                          1                         11
11                                                   11       11                11                         1                         11
11                                                   11       11                11                         1                         11
11                                                   11       11                11                         1                         11
1111111111111111111111111111111111111111111111       11111111111111111111       1111111111        1        1       11111111111       11
11                                          11                                  1                 1        1        1                11
11                                          11                                  11                1        1        1                11
11                                          11                                  11                1        1        1                11
11                                          11                                  11                1        1        1                11
11       1111111111111111111111111111       11       1111111111111111111111111111        1111111111        1        1111111111111111111
11       1                         11       11       11                                  1                 1                         11
11       1                         11       11       11                                  1                 1                         11
11       1                         11       11       11                                  1                 1                         11
11       1                         11       11       11                                  1                 1                         11
11       1       11111111111111111111       11       11111111111       1111111111111111111111111111111111111        1111111          11
11       1                                  11                         11                                  1        1                11
11       1                                  11                         11                                  1        1                11
11       1                                  11                         11                                  1        1                11
11       1                                  11                         11                                  1        1                11
11       1111111111111111111111111111       11       11111111111111111111       1                 1        1        1        1       11
11                                 11       11       11                         11                1        1        1        1       11
11                                 11       11       11                         11                1        1        1        1       11
11                                 11       11       11                         11                1        1        1        1       11
11                                 11       11       11                         11                1        1        1        1       11
11       1111111111111111111       11       11       11        1111111111111111111                1        1        1       11111111111
11       11 1111111111111 11       11       11       11        1                11                1        1        1                11
11       1                11       11       11       11        1                11                1        1        1                11
11       1                11       11       11       11        1                11                1        1        1                11
11       1                11       11       11       11        1                1                 1        1        1                11
11       1                11       11       11111111111        1       1   111111111111111111111111        1111111111111111111       11
11       1                11       11                          1                                                                     11
11       1                11       11                          1                                                                     11
11       1                11       11                          1                                                                     11
11       1                11       11                          1                                                                     11
11       1                11       11                          1                                                                     11
11       1                11        111111111111111111111111111111111111111111111111111111111111111111111111111111111111111111       11
11                        11                                                                      1                                  11
11                        11                                                                      x                                  11
11                        11                                                                      x                                  11
11                        11                                                                      x                                  11
111111111111111111111111111111111111111111111111111111111111111111111111111111111111111111xxxxxxxx1111111111111111111111111111111111111